1 1 1 1 1 1 1 1 1 1 1 1 1 1 1 1
0 0 4 1 1 3 3 3 3 3 3 3 3 3 3 3
0 0 0 1 1 3 4 3 0 0 0 0 0 0 0 0
0 0 0 0 1 1 3 3 0 0 4 0 0 4 0 0
0 0 0 0 8 8 8 8 0 0 0 0 0 0 0 0
0 0 0 0 0 4 1 1 3 3 3 0 0 0 0 0
0 0 4 0 0 0 0 1 1 1 1 3 0 0 0 0
0 0 0 0 0 0 0 0 0 0 1 1 1 3 3 0
0 0 0 4 0 0 0 0 0 0 1 1 3 4 3 0
0 0 0 0 0 0 0 0 0 0 0 1 1 3 3 0
0 0 0 0 0 0 0 0 0 0 0 6 1 1 3 3
5 5 5 5 5 5 5 5 5 5 5 6 6 1 1 1